10x20
********************
**          **     *
*  *        *   ** *
*    *      *      *
**  *    *     *   *
* **        *      *
*    *     *  *    *
*         *    *  **
*  *     *  *      *
********************
