10x20
********************
*R*  *             *
*              *   *
**               * *
*      *     * *   *
*    *      *  H   *
*                  *
** *   * ***     ***
*     *            *
********************
