10x20
********************
* **   *    *   *  *
* *      *         *
*  *    *   **   * *
*   * *   *   *  ***
*  *   R    H      *
***  *   *     *  **
*     R      * *  **
*    R    *  *     *
********************
