10x20
********************
*    R    *        *
**      *   R   * **
* ** R             *
*      **  R    R  *
*   R    *  *    R *
**         H       *
* *   *        *   *
* *  R    R   *  R *
********************
