10x20
********************
*R*  *             *
*        R     *   *
**               * *
*      *     * *   *
*    H  R   *      *
*                  *
** *   * ***  R  ***
*     *            *
********************
